...#####
..##.#.####
.##..#.#..#
##.....#..#
#..@...#..#
#######.###
#.#..#....#
###########