###########
#.........#
#.#.#.###.#
#.###..#..#
#.#.#..#..#
#.#.#.###.#
#....@....#
###########