###########
#.........#
#.........#
#..@......#
#.........#
#.........#
#.........#
###########