###########
#.........#
#..#...#..#
#..@.#....#
#.#.....#.#
#..#####..#
#.........#
###########